[
  "WWWWWWWWWWWWWWWWWWWWWWWWWWW",
  "WCCCCCCCCCCCCCCCCCCCCCCCCCW",
  "WCWWWWCWWWWWWCWWWWWWCWWWWCW",
  "WCCCCCCCCWCCCCCCCWCCCCCCCCW",
  "WWWCWWWWCWCWWCWWCWCWWWCWWWW",
  "WCCCCCCCCCCCCCCCCCCCCCCCCCW",
  "WCWWWWWWWWWWWCWWWWWWWWWWWCW",
  "WCCCCCCCCCWWWCWWWCCCCCCCCCW",
  "WWWWWCWWWCWWWCWWWCWWWCWWWWW",
  "WCCCCCCCCCCCCCCCCCCCCCCCCCW",
  "WCWWWCWWCWWWWCWWWWCWWCWWWCW",
  "WCWWWCWWCWNNNNNNNWCWWCWWWCW",
  "CCCCCCCCCWNNNNNNNWCCCCCCCCC",
  "WCWWWCWWCWNNNNNNNWCWWCWWWCW",
  "WCWWWCWWCWWWWWWWWWCWWCWWWCW",
  "WCCCCCCCCCCCCCCCCCCCCCCCCCW",
  "WWWWWCWWWCWWWCWWWCWWWCWWWWW",
  "WCCCCCCCCCWWWCWWWCCCCCCCCCW",
  "WCWWWWWWWWWWWCWWWWWWWWWWWCW",
  "WCCCCCCCCCCCCCCCCCCCCCCCCCW",
  "WWWCWWWWCWCWWCWWCWCWWWCWWWW",
  "WCCCCCCCCWCCCCCCCWCCCCCCCCW",
  "WCWWWWCWWWWWWCWWWWWWCWWWWCW",
  "WCCCCCCCCCCCCCCCCCCCCCCCCCW",
  "WWWWWWWWWWWWWWWWWWWWWWWWWWW"
]
