[
  "WWWWWWWWWWWWWWWWWWWWWWWWWWW",
  "WCCCCCCCCCCCWWWCCCCCCCCCCCW",
  "WCWWWCWWWWWCWWWCWWWWWCWWWCW",
  "WPCCCCCCCCCCCCCCCCCCCCCCCPW",
  "WCWWWCWCWWWWWWWWWWWCWCWWWCW",
  "WCCCCCCCCWWWNNNWWWCCCCCCCCW",
  "WWWWWCWWWWWWNNNWWWWWCWWWWWW",
  "PCCCCCWWWCCCCCCCCWWWCCCCCCP",
  "WWWWWCWWWCWWWWWWWCWWWCWWWWW",
  "WWWWWCWWWCWWWWWWWCWWWCWWWWW",
  "WWWWWCCCCCCCCCCCCCCCCWWWWWW",
  "WWWWWCWWWCCCCCCCWWWCWWWWWW",
  "WWWWWCWWWWWWWWWWWWWCWWWWWW",
  "PCCCCCCCCCCCWWWCCCCCCCCCCP",
  "WWWWWCWWWWWCWWWCWWWWWCWWWWW",
  "WWWWWCCCCCCCCCCCCCCCCWWWWWW",
  "WWWWWCWWWCWWWWWWWCWWWCWWWWW",
  "WCCCCCCCCWWWCCCWWWCCCCCCCCW",
  "WCWWWWWWWWWWCCCWWWWWWWWWCW",
  "WPCCCCCCCCCCCCCCCCCCCCCCCPW",
  "WWWCWCWWWWWWWWWWWWWWWCWCWWW",
  "WCCCCCCCCWWWCCCWWWCCCCCCCCW",
  "WCWWWWWWWWWWCCCWWWWWWWWWCW",
  "WCCCCCCCCCCCCCCCCCCCCCCCCW",
  "WWWWWWWWWWWWWWWWWWWWWWWWWWW"
]
